                                                                   --.-|                 
                                                                  -......-                
                                                                  ........-               
                              .---------.                       |........-               
                           --..............---              |-----........-               
                        --.....................-.           ---..........-                
                       -..........................-|          -.........-                 
                      -.............................-.        -.........-                 
                     -...............................-         ..........                 
                     ................................-        .........-                  
                     ....--.|.........................-.      -........|                  
                     -...|  ............................|   .-........-                   
                    -.....- -............................  |..........|                   
                    |.....- |............................-...........-                    
                     ||-|.   .--......................................                    
                               -....................................|                     
                                ...................................-                      
                              |-...................................|                      
                            |......................................                       
                          |-.......................................-                      
                        .-..........................................-                     
                       -.............................................-                    
                      |...............................................-                   
                     |.................................................-                  
                    -...................................................                  
                   ..........-|.........................................                  
                 .--........- -........................................|                  
                -..........-  -.........................................                  
                -..........-  -.........................................|                 
                ...........- .-..........................................-.               
                -..........|..............................................-               
               |........--.--............................................-|               
               |........- - -..........................................--                 
                -.......    .-.......................................-|                   
                 |-...-.       ||-.................................-.                     
                                   |.............-||-.............-                       
                                    ............-    ...........-.                        
                                    |-..........-    |..........-|                        
                                    ............     |...........-                        
                               ...   -..........-    -..........-   ...                   
                             |.....-|-..........|    -..........|--....--                 
                            -...................      ...................-                
                            -...................-    -...................-                
                             -...................-    -...................| 
			     ------------------------------------------------


