+------------------------+
|........................|
|........................|
|........................|
+--#-----------+.........|
   #           |.........|
   #           |.........|
   #############.........|
               +---------+
