 +----------------+                                                       
 |................|                           +------------+              
 |................#############################............|              
 |................|                           |............#############  
 |................|       +------------+      |............|              
 +----#---------#-+     ###............|      +-#----------+              
      #         #       # |............|        #                         
      #         ######### |............##########                         
      #                   +------------+                                  
      #                                                                   
      #                                                                   
 +----#-------------------------------------------------------------+     
 |..................................................................|     
 |..................................................................|     
 |..................................................................|     
 |................+------------------------+........................|     
 |................|                        |........................|     
 |................|                        |........................|     
 |................|                        |........................|     
 |................|                        |........................|     
 |................|                        |........................|     
 |................+------------------------+........................|     
 |..................................................................|     
 |..................................................................|     
 |..................................................................|     
 +------------------------------------------------------------------+     
