+-------------+    +--------------------+                      
|.............|    |....................|                      
|.............|    |.....+-------+......|                      
|.............|    |.....|       |......|                      
+------#------+    |.....|       |......|                      
       #           |.....|       |......|          ##########  
       ########    +-----+       +---#--+          #        #  
              #                      #             #        #  
              #    +---------+       #######       ##########  
              #    |.........|       #     #     +-#--+        
              ######.........#########     #     |....|        
                   |.........|       #############....|        
                   +---#-----+                   |....|        
                       #                         +--#-+        
                       #                            #          
        +------+ +-----#--+ +--------+  +-----+     #    +----+
        |......| |........| |........|  |.....|     #    |....|
        +-+....| |........| |........####.....|     #    |....|
          |....| |........| |........|  |.....############....|
          |....| +----#---+ +---#----+  +-----+          |....|
          |....|      #         #                        |....|
          +-#--+      ###########    +-------------------+....|
            #         #         #    |........................|
            #####################    |.......+-------+........|
                                     |.......|       |........|
                                     |.......|       |........|
                                     |.......+-------+........|
                                     |........................|
                                     |........................|
                                     +------------------------+
