    +-------+                                                                     +------+           
    |.......|                                                                     |......|           
    |.......|                                                                     +-#----+           
    |.......|                                                                       #                
    +-----#-+                                                                       #                
          #                                                                         #                
          #                                                                         #                
          #                                                                         #                
    +-----#-+                                                                       #                
    |.......|                                                                       #                
    |.......|                                                                       #                
    |.......|                                                                    +--#------------+   
    +-#-----+                                                                    |...............|   
      #                                                                          |...............|   
      #                                                                          +------#--------+   
      #                                                                                 #            
    +-#-----------+                                                                     #            
    |.............|                                                                     #            
    |...+-----+...|                                                                     #            
    |...|     |...|                                                         +-----------#-+          
    |...|     |...|                                                         |.............|          
    |...+-----+...###########################################################.............|          
    |.............|                                                         +-------------+          
    +-------------+                                                                                  
