        +-----------+                             +-----------+         
        |...........|                             |...........|         
        |...........########               ########...........|         
        |...........|      #               #      |...........|         
        +-#---------+      #               #      +---------#-+         
          #                #################                #           
    #######                        #                        #######     
    #                              #                              #     
    #                     +--------#--------+                     #     
    #                     |.................|                     #     
+---#----+                |.................|                 +---#----+
|........|                |...+---------+...|                 |........|
|........|                |...|         |...|                 |........|
|........|                |...+---------+...|                 |........|
+---#----+                |.................|                 +---#----+
    #                     |.................|                     #     
    #                     +--------#--------+                     #     
    #                              #                              #     
    #######                        #                        #######     
          #                #################                #           
        +-#---------+      #               #      +---------#-+         
        |...........|      #               #      |...........|         
        |...........########               ########...........|         
        |...........|                             |...........|         
        +-----------+                             +-----------+         
