+---+                                                                                  +---+
|...+---+                                                                          +---+...|
|.......+---+                                                                  +---+.......|
|...........+---+                                                          +---+...........|
|...............+---+                                                  +---+...............|
|...................+---+                                          +---+...................|
|.......................+---+                                  +---+.......................|
|...........................+---+                          +---+...........................|
|...............................+---+                  +---+...............................|
|...................................+---+          +---+.....................+-------------+
|.......................................+----++----+.........................#.............|
|............................................||..............................+-------------+
|............................................||............................................|
|............................................##............................................|
|-----------------#---------------#----------##-------------------#---------------#--------|
|---------------------------------#----------##-------------------#---------------#--------|
|-----------------#---------------#----------##-------------------#------------------------|
|-----------------#---------------#----------##-------------------#---------------#--------|
|............................................##............................................|
|............................................||............................................|
|............................................||....................+-------+...............|
|.......................................+----++----+...............|.......|...............|
|...................................+---+        +---+.............|.......|...............|
|...............................+---+                  +---+.......|.......|...............|
|---#---+...................+---+                          +---+...|.......#...............|
|.......|...............+---+                                  +---+.......|...............|
|.......#...........+---+                                          +---+...|...............|
|.......|.......+---+                                                  +---+...............|
|.......|...+---+                                                          +---+...........|
|.......+---+                                                                  +---+.......|
|...+---+                                                                          +---+...|
+---+                                                                                  +---+
