         +----+      +-----------+ 
         |....|      |...........| 
         |....####   |.....+--#--+ 
         |....|  #   |.....|  #    
   +-----+....|  #   |.....|  #    
   |..........|  #   |.....|  #    
   |..+---+...|  #   |.....|  #    
   |..|   |...|  #   |.....+--#--+ 
   |..+---+...|  #####...........| 
   +------#---+  #   +---#-------+ 
          #      #       #         
          #  #####       #         
   +------#--#-+     +---#-+       
   |...........|     |.....|       
   |..+-----+..|     |.....|       
   |..|     |..#######.....|       
   |..+-----+..|     |.....#####   
   |...........|     |.....|   #   
   +--------+..|     |.....+---#--+
            |..|     |............|
            +--+     +------------+
