+----------------------+      +-----------------------+         +-------------------------+
|......................|      |.......................|         |.........................|
|......+--------+......|      |......+---------+......|         |.........................|
|......|        |......|      |......|         |......|         |.........................|
|......|        |......|      |......|         |......|         |.......+---------+.......|
|......|        |......|      |......|         |......|         |.......|         |.......|
|......|        |......|      |......+---------+......|         |.......|         |.......|
|......+--------+......|      |.....................+-+         |.......|         |.......|
|......................|      |.....................|           |.......|         |.......|
+---------------+......########.......+-------+.....#############.......|         |.......|
                |......|      |.......|       |.......|         |.......|         |.......|
                |......|      |.......|       +-+.....+-+       |.......|         |.......|
                |......|      |.......|         |.......|       |.......|         |.......|
                |......|      |.......|         +-+.....|       |.......|         |.......|
+------+        |......|      |.......|           |.... +-+     |.......|         |.......|
|......|        |......|      |.......|           +-+.....|     |.......|         |.......|
|......+--------+......|      |.......|             |.....+-+   |.......|         |.......|
|......................|      |.......|             |.......|   |.......|         |.......|
###########################################################################################
