+-----+----------------+    +-----------+--------------+    +-----------------------+ +-+
|......................|    |...........|..............|    |.......................| |.|
|......................|    |...........#..............|    |.......................###.|
|.....+-----+----------+    |...........|..............|    |.......................| |.|
|...........|               |.........+-+--#----+......+-+  |.....+---#-----#-------+ +-+
|...........#################.........|    #    |........|  |.....|   #     #            
|...........|               |.........###########........####.....|   #     #            
|...........+----------+    |.........|    #    |........|  |.....|   #     #            
|...........|..........|    |.........+----#--+-+......+-+  |.....+---#-----#-------+    
|...........#..........######.................|........|    |.......................|    
|...........|..........|  # |.................#........######.......................|    
|...........|..........|  # |.................|........|    |.......................|    
|...........+----------+  # |.........+----#--+-+......+-+  |.......................|    
|...........|            ## |.........|    #    |........|  +------#----#--#--+--#-+|    
|...........##############  |.........###########........|         #    #  #  |.....|    
|...........|            ## |.........|    #    |........|         #    #  #  |.....|    
+------#----+----------+  # |.........+----#----+---#--+-+         #    #  #  |.....|    
|...........|..........|  # |..........................|    +------#----#--#--+.....|    
|...........#..........|  # |..........................|    |.......................|    
|...........|..........|  # |..........................|    |.......................|    
+-------#---+----------+  # +------------#-------------+    +--------------------#--+    
        #                 #              #                                       #       
        #                 #              #                                       #       
        ##########################################################################       
