+----------------------+         +----------------------+         +------+                         +------+                        +----------------------+
|......................|         |......................#####     |......|   ########              |......########    ##############......................|
|......................|   #######......................|   #     |......|   #      #     ##########......|      #    #            |......................|
+---------------+......|   #     |......+---------------+   #     |......|   #      #######        |......|      #    #            |........+----+........|
                |......|   #     |......|                   #     |......|   #            #        |......|      ######            |........|    |........|
    #############......|   #     |......+------+            #     |......|   #            #        |......|      #    #            |........#### |........|
    #           |......|   #     |.............#####        #     |......|   #          ###        |......|      #    #            |........|  # |........|
    #           |......|   #     |.............|   #        #     |......|   ######     #          |......########    #      #     |........|  # |........|
+---#--+        |......|   #     |......+------+   #        #     |......|        #     ######     |......|           #      #     |........|  ###........|
|......|        |......|   #     |......|          #        #     |......|        #          #     |......|           #      #     |........|    |........|
|......+--------+......|   #     |......+----------#----+   #     |......+--------#------+   #######......+-----------#---+  #     |........+----+........|
|......................#####     |......................###########......................|         |......................|  #     |......................|
|......................|         |......................|         |......................|         |......................####     |......................|
+----------------------+         +----------------------+         +----------------------+         +----------------------+        +----------------------+
