  +----------+                                                                 
  |..........|                 +----------------------------------+            
  |..........###################..................................|            
  |..+----+..|                 +-----#--------------------------+.|            
  |..|    |..|      +-----+          #                          |.|            
  |..|    |..|      |.....|          ################   ####### |.|            
  |..|    |..|    +-+.....+-+        #     +--------#+  #     # |.|            
  |..|    |..|    |.........|        #     |.........|  #     ##|.|            
  |..|    |..|  +-+.........+-+      ####  |.........#### +---+##.|            
  |..+----+..|  |.............|         ####.........|    |...| |.|            
  |..........|  +------#------+            +---------+    +-#-+ |.|            
  +----#-----+         #         #### ###     ###  ##########   |.|            
  ######################         #  ### ####### #  #  +---------+.|            
  #  +-----------------#---------#-----+        #  #  |...........|            
  ####.................................|        ####  |...........|            
     |.................................|        #     |...+---+...|            
  +--+..+-----+..............+------+..|        #     |...|   |...|            
  |.....|     |..............|      |..################...+---+...|            
  |.....|     |..............|      |..|              |...........|            
  +-----+     +--------------+      +--+              +-----------+            
