+-----------------+             
|.................|             
|.................|             
|.................###########   
|......+----+.....|         #   
|......|    |.....|         #   
|......+----+.....|         #   
|.................|         #   
+-----------------+      +--#--+
                         |.....|
+-----------------+      |.....|
|.................|      +--#--+
|.................|         #   
|.................###########   
|......+----+.....|             
|......|    |.....|             
|......+----+.....|             
|.................|             
+-----------------+             
