

                                                                                               
   +------------------------------------------------------------------------------------------+
   |..........................................................................................|
   |..........................................................................................|
   |..........................................................................................|
   |..........................................+-----------+...........+----------------+......|
   |..........................................|           |...........|                |......|
   +----------------------+...................|           |...........|                |......|
                          |....+-------+......|           |...........|                |......|
                          |....|       |......|           |...........+----------------+......|
                          |....|       |......|           |...................................|
                          |....|       |......|           +-----------------------------------+
                          |....+-------+......|                                                
                          |...................|                                                
                          +-------------------+                                                
