  +-------------------------------+                      +-------------------------------+ 
  |...............................#######################|...............................| 
  |.........+----------+..........#                      #.........+----------+..........| 
  |.........|.....................#                      #.........|.....................| 
  |.........|.....................#                      #.........|.....................| 
  |.........|.....................#                      #.........|.....................| 
  |.........|.....................#######################|.........+----------+..........| 
  |.........|.....................#                      #....................|..........| 
  |.........|.....................#                      #....................|..........| 
  |.........|.....................#                      #....................|..........| 
  |.........+----------+..........#                      #.........+----------+..........| 
  |...............................#######################|...............................| 
  +-----------------------#------+#                      #+-------#----------------------+ 
      #####################        #                    #         #################        
      #                             #                  #                         #         
      #                              #                #                         #          
      #                               #              #                         #           
      #                                #            #                         #            
      #####################             #          #                         #             
                          #              #        #                         #              
                          #               #      #                         #               
                          #                #    #                         #                
                          #                 #  #                         #                 
      #####################################################################################
                              +--------------##---------------+                            
                              |...............................|                            
                              |...............................|                            
                              |.....+-------+...+-------+.....|                            
                              |.....|...........|       |.....|                            
                              |.....|...........|       |.....|                            
                              |.....+-------+...|       |.....|                            
                              |.............|...|       |.....|                            
                              |.............|...|       |.....|                            
                              |.....+-------+...+-------+.....|                            
                              |...............................|                            
                              |...............................|                            
                              +-------------------------------+                            
