                               +---------+                                     
                               |.........|                                     
                               +-----#---+                                     
                                     #                                         
                                     #                                         
               +-----------+         #     +---------+                         
               |...........|         #     |.........|                         
               |...........##############  |.........|                         
               |...........|            #  |.........|                         
               +---#-------+            ####.........|                         
                   #                       +----#----+                         
                   #                            #    +-----------+             
     +-------------#-------------------+        #    |...........|             
     |.................................|        ######...........|             
     |.................................|        #    |...........|             
     |......+---------------+..........|        #    |...........|             
     |......|               |..........##########    +---#----#--+             
     |......|  +--------+   |..........|                 #    #                
     |......|  |........|   |..........|                 #    #                
     |......|  |........|   |..........|                 #    #                
     |......|  +---#----+   |..........|                 #    #                
     |......|      #        |..........########################                
     |......+------#--------+..........|                                       
     |.................................|                                       
     |.................................|                                       
     |.................................|                                       
     |.................................|                                       
     |.................................|                                       
     |.................................|                                       
     |.................................|                                       
     |.................................|                                       
     +---------------------------------+                                       
