              +----------+              
              |..........|              
              |..........|              
          +---+..........+---+          
          |..................|          
          |..................|          
          +---+...........+--+          
              |...........|             
              |...........|             
              |...........|             
              |...........|             
              |...........|             
              |...........|             
              +-----#-----+             
                    #                   
             ###############            
             #             #            
             #             #            
   +---------#---+     +---#---------+  
   |.............|     |.............|  
   |.............|     |.............|  
   |.............|     |.............|  
   +-----#-------+     +---------#---+  
         #                       #      
        ###                     ###     
        ###                     ###     
       #####                   #####    
