 +-----------------------------+  +-----------------------------+ 
 |.............................|  |.............................| 
 |.+----------+.+------------+.|  |.+------------+.+----------+.| 
 |.|          |.|            |.|  |.|            |.|          |.| 
 |.+----------+.+------------+.+--+.+------------+.+----------+.| 
 |..............................................................| 
 |.+----------+.+-+.+------------------------+.+-+.+----------+.| 
 |.|          |.| |.|                        |.| |.|          |.| 
 |.|          |.| |.+------+          +------+.| |.|          |.| 
 |.+----------+.| |........|          |........| |.+----------+.| 
 |..............| +------+.|          |.+------+ |..............| 
 +------------+.|        |.|          |.|        |.+------------+ 
              |.| +------+.+----------+.+------+ |.|              
              |.| |............................| |.|              
              |.| |.+------------------------+.| |.|              
 +------------+.+-+.|                        |.+-+.+------------+ 
##..................|                        |..................##
#+------------+.+-+.+------------------------+.+-+.+------------+#
#             |.| |............................| |.|             #
#             |.| |.+------------------------+.| |.|             #
#             |.| |.|                        |.| |.|             #
#+------------+.+-+.+------+          +------+.+-+.+------------+#
#|.........................|          |.........................|#
#|.+----------+.+--------+.|          |.+--------+.+----------+.|#
#|.|          |.|        |.|          |.|        |.|          |.|#
#|.+------+   |.+--------+.+----------+.+--------+.|   +------+.|#
#|........|   |....................................|   |........|#
#+------+.|   |.+-+.+------------------------+.+-+.|   |.+------+#
#       |.|   |.| |.|                        |.| |.|   |.|       #
#+------+.+---+.| |.+------+          +------+.| |.+---+.+------+#
#|..............| |........|          |........| |..............|#
#|.+------------+ +------+.|          |.+------+ +------------+.|#
#|.|                     |.|          |.|                     |.|#
#|.+---------------------+.+----------+.+---------------------+.|#
#|..............................................................|#
#+--------------------------------------------------------------+#
##################################################################
